नम्रता, आँचल, बर्षा, सिपोरा र बेनिशामा को उत्कृष्ट ?

गतबर्ष यूएइको अवुधाबीमा आयोजना भएको ‘पहिलो नेपाली म्यूजिक भिडियो अवार्ड’ले सफलता पाएपछि यसको आयोजक संस्था संगिक्षा फिल्मस् उत्साहित भएको थियो । सोही अनुरुप, संगिक्षा फिल्मस्ले दुबइमा रहेको नमस्ते ट्राभल्ससँग सहकार्य गर्दै ‘दोश्रो नेपाली म्यूजिक भिडियो अवार्ड’ पनि दुबइमा आयोजना गर्ने भएको छ ।
काठमाण्डौमा मंगलबार आयोजना गरिएको पत्रकार सम्मेलनमा उत्कृष्ट ५ को नाम सार्वजनिक गरियो । म्यूजिक र भिडियो गरि दुई समुहमा विभाजन गर्दै विभिन्न १७ विधामा अवार्ड आयोजना गरिनेछ ।
संगिक्षा फिल्मस्का अध्यक्ष मनोज केसीले भव्य रुपमा कम भन्दा कम विवादमा अवार्ड आयोजना गर्ने बताएका छन् । यस्तै, अवार्डका जुरी संयोजक भरत शाक्यले उत्कृष्ट गीतहरुलाई विभिन्न चरणमा विभाजन गर्दै अन्तिम ५ सार्वजनिक गरिएको बताए ।  
यो बर्ष आयोजना हुन लागेको अवार्डमा ‘लाइफ टाइम कन्ट्रिब्यूसन’बाट गीतकार तथा चिकित्सक डाक्टर भोला रिजाललाई सम्मानित गरिनेछ । यस्तै, ‘स्पेशल कन्ट्रिब्यूसन’को रुपमा विशेष श्रेष्ठलाई सम्मानित गरिने कार्यक्रममा जानकारी दिइयो । यस्तै, ‘म्यूजिक भिडियो ट्रेन्ड सेटर’ अवार्डको रुपमा चर्चित गीत ‘साँइली’लाई अवार्ड प्रदान गरिनेछ ।
कार्यक्रममा नेपाली कांग्रेसका नेता तथा पूर्व उपप्रधानमन्त्री प्रकाशमान सिंहले उत्कृष्ट ५ मा पर्न सफल कलाकर्मीलाई प्रमाणपत्र वितरण गरेका थिए ।         
कार्यक्रममा मोडलहरु नम्रता सापकोटा, आँचल शर्मा, सिपोरा गुरुङ, यशराज, दिकपाल कार्की लगायत पुगेका थिए । दुबइमा सेप्टेम्बर महिनामा आयोजना हुन लागेको अवार्डको अन्तिम ५ मा पर्न सफल म्यूजिक भिडियो, गीत र कलाकर्मीको नाम यसप्रकार छः
Category A – Music
1a.Best Vocal(Male)

Pramod Kharel – Laidaina Mayale
Roopak Dotel – Niyali Here
Susan Samsohang- Soltini
Trolok Rana – Kanda Chhoye Phool Banchha
Yubraj Chaulagain – Maanko Daag

2a.Best Vocal(“emale)

Mallika Karki – Ma Timro Mayamaa
Milan Amatya – Laththai Banayo
Prasna Shakya – Ma ta Sojhi Sojhi
Rekha Paudel – Sukha Pani Adhaa
Anuska Pathak – Maanko Daag

3a.Best Vocal Pop(Male)

Arjun Kausal– Timro Ranga Rasilo
Deepak Bajracharya – Allare
Subhas Bhusal- Ek Pal Mutumaa
Sunil Singh Thakuri – Dimag Khali
Ujan Nembang– Timro Yaadmaa

4a.Best Vocal Pop(female)

Akanchha Bashyal – Ma Paglanchhu
Anjila Regmi – Kapuri Ka
Durga Kharel – Timro Maya
Pramila Tamang – Lahureki Chhori
Ramila Gyangmi Magar – Chuk Chuk Relaima

5a.Best Lyric

Dilip Piya – Laththai Banaeu
Naresh Bhattarai – Maile Hare wa Jite
Purna Limbu – “arak Maanchhe
Roshan Bhattarai – Mayalu Muhar Timro
Shantipriya – Ma ta Maya Garne Manchhe

 
6a.Best Music

Alok Shree – Nuhaauna Khola Bhitra Napasana Saani
Arjun Pokharel – Yasto Maya
Hari Lamsal – Soltinee
Sachin Singh – Siraima Sirbandi
Sunil Maskey – Ma ta Sojhi

7a.Best Arrangement

Amul Karkidhali – Malai Maya Garne
Bijeshwor Tandukar – Najik Chhau
Maharaj Thapa – Dhungako Bhar
Mohit Munal – Cham Cham
Udayaraj Paudel – Chuk Chuk Rail,

8a.Best Recordist

“iroj Bajracharya- Allare
Kishor Thapa – Kaanda Chhoye Pool Banchha
Krishna Kumar Maharjan – Timro Paila Sanga Sangai
Rajeshswor Tandukar- Timro Pauju
Shambhu Kumar Tandukar – Chashmawala

9a.Best Lok Dohari

Bal Bahadur Gurung – Baishalu Jowan
Binaya Khatri – Aamako Maya
Bhagawati Upreti – Kanchhi Swasni
B. Anuragi – I Love you
Khuman Adhikari – Keti Patyaaune

Category B-Video
1b.Best Music Video

Bikasa Entertainment/ Subhas Bhusal – EkPal Mutuma
Biru Magar Bichhod/ Trilok Rana – Kanda Chhoye
Dev D Entertainment/ Anand Karkui – Sunsaan
Krishna Gurung/ Rajesh Payal Rai – Himalako Kakhamaa
SZ Creation/ Deepak Bajracharya – Allaare

 2b.Music Video Director

Bikash Subedi – Ek Pal Mutuma
Bishal Bhandari – Kada Chhoye
Dipendra KC – Sunsaan
Shreedhar Paudel – Cham Cham
Subrat Acharya – Allare

3b.Music Video Cameraperson

Anil K Manandhar – Pal Pal Mutuma
Arjun Tiwari – Gudi Jane Rail
Dhiraj Jung Shah – Ma ta Sojhi
Prakash Gurung – Himalako Kakhamaa
Utsav Dhakal – Timi Hau Saagar

4b.Music Video Editor

Bharat Regmi – Allare
Nishan Ghimire – Sir Sir
Prabin Shrestha – Mayalu Muhar Timro
Suprim Parajuli – Chuk chuke Rail
Tekendra Shah – Pal Pal

5b.Best Actor

Binod Singh – Anjanmai ho ya Jani Jani
Dikpal Kakri – Pir Maanma
Pushpal Khadka – Cham Cham
Sraj Grach – Timilai Bhani
Vibek Singh Thakuri – Mayalu Muhar Timro

6b. Best Actress

Aachal Sharma – Ek Pal Mutu
Barsha Raut – Timro Pauju
Benisha Hamal – Kanda Chhoye
Namrata Sapkota – Thaha Chhaina
Sipora Gurung – Himalko Kakhamaa

7b.Best Choreography

Dipendra Timilsina – Baishalu Joban
Kranti KC – Beauty Beauty Chha
Sankar BC – Keti Patyaune
Shiva BK – I Love You
Sunil Chhetri – Laideuna Mayale

Category C- Special
1c.Best Emerging Talant 

Ananta Timilsina (Director) – Timro Paila Sanga Sangai
Bhabin Dhungana (Vocal) – Barsiyo Aaja Maan Mero
Kishor Siwakoti (Vocal) – Gudujane Rail
Prem Sen (Vocal) – Timro Pauju
Ruksana Shrestha (Actor) – Timilai Bhani
Saan Thapa (Director) – Timihau Saagar
Sanjib Parajuli (Vocal) – Nai Malai Thaha Chhaina


